0000000000000000000000000000000000000000000000000000000000000000000000000000000000000000000000000000000000000000000000000000
0000000000000000000000000000000000000000000000000000000000000000000000000000000000000000000000000000000000000000000000000000
0000000000000000000000000000000000000000000000000000000000000000000000000000000000000000000000000000000000000000000000000000
0000000000000000000000000000000000000000000000000000000000000000000000000000000000000000000000000000000000000000000000000000
0000000000000000000000000000000000000000000000000000000000000000000000000000000000000000000000000000000000000000000000000000
0000000000000000000000000000000000000000000000000000000000000000000000000000000000000000000000000000000000000000000010000000
0000000000000000000000000000000000000000000000000000000000000000000000000000000000000000000000000000000000000000000010000000
0000000000000000000000000000000000000000000000000000000000000000000000000000000000000000000000000000000000000000000010000000
0000000000000000000000000000000000000000000000000000000000000000000000000000000000000000000000000000000000000000000010000000
0000000000000000000000000000000000000000000000000000000000000000000000000000000000000000000000000000000000000000000010000000
0000000000000000000000000000000000000000000000000000000000000000000000000000000000000000000000000000000000000000000010000000
0000000000000000000000000000000000000000000000000000000000000000000000000000000000000000000000000000000000000000000010000000
0000000000000000000000000000000000000000000000000000000000000000000000000000000000000000000000000000000000000000000010000000
0000000000000000000000000000000000000000000000000000000000000000000000000000000000000000000000000000000000000000000010000000
0000000000000000000000000000000000000000000000000000000000000000000000000000000000000000000000000000000000000000000010000000
0000000000000000000000000000000000000000000000000000000000000000000000000000000000000000000000000000000000000000000010000000
0000000000000000000000000000000000000000000000000000000000000000000000000000000000000000000000000000000000000000000010000000
0000000000000000000000000000000000000000000000000000000000000000000000000000000000000000000000000000000000000000000010000000
0000000000000000000000000000000000000000000000000000000000000000000000000000000022222222200222222000000000000000000010000000
0000000000000000000000000000000000000000000000000000000000000000000000000000000010000001000010001220000000000000000010000000
0000000000000000000000000000000000000000000000000000000000000000000000008000000010000001888810001000000000000000000010000000
0000000000000000000000000000000000000000000000000000000000000000000000222200000012222222222222222000000222200000000010000000
00000000000000000000000000000000000000000000000000000000000000000800000101000000100000000000000000000001001g00800*0010000000
0000000000000000000000000000000000000000000000000000000000000000222000010100000010000000000000000000005100122222220010000000
0000000000000000000000000000000000000000000000000000000000080000010000010100002222000000000000000000022100100000000010000000
0000000800000000000000000000000000000000000000000000000000222000010000010100000000000000000000000000000100100000000010000000
222000222000000000000000000000000000000000000000000080000001000001000001010000000000g00800g00800g000800d00100000000010000000
0100000100008000000000000000000000000000000000000002220000010000010000010100002222222222222222222222222100100000000010000000
0100000100000000880000000000000000000000000008380000100000010000010000010100000000000000000000000000000100100000000010000000
01000001000000222222000000000000000000000000022200001000000100000100000101200000000000000000000000000001001000*00800d0000000
0100000100000001001000000000000000000000000000100000100000010000010000010100000000000000000000000000000100100002222210000000
010000010000000100100000000000000000000*000000d00000100000010000010000010100002222222000000000000000000100108000000010000000
0100000100000001001000000g00888800*00000222222100000100000010000010000010100000100010000000000000000000100108000000010000000
010000010000000100100000012222222200000001000010000010000001000001000001012g080d00010022200000000000000100100000090010000000
010000010000000100100000010000000100000001000010000010000001000001000001010222210001000100*00000000*400100100000000010000000
0100000100000001001000000100000001000000010000100000100000010000010000010100100100010001000222222222222100100002222210000000
0100000100000001001000000100000001000000010000100000100000010000010000010100100100010001000100000100000100100000000010000000
0100000100000001001000000100000001000000010000100000100000010000010000010100100100010001000100000100000100100000000010000000
0100000100000001001000000100000001000000010000100000100000010000010000010100100100010001000100000100000100100000000010000000
0100000100000001001000000100000001000000010000100000100000010000010000010100100100010001000100000100000100100000000010000000
0100000100000001001000000100000001000000010000100000100000010000010000010100100100010001000100000100000100100000000010000000
0100000100000001001000000100000001000000010000100000100000010000010000010100100100010001000100000100000100100000000010000000
0100000100000001001000000100000001000000010000100000100000010000010000010100100100010001000100000100000100100000000010000000
0100000100000001001000000100000001000000010000100000100000010000010000010100100100010001000100000100000100100000000010000000
0100000100000001001000000100000001000000010000100000100000010000010000010100100100010001000100000100000100100000000010000000
0100000100000001001000000100000001000000010000100000100000010000010000010100100100010001000100000100000100100000000010000000
0100000100000001001000000100000001000000010000100000100000010000010000010100100100010001000100000100000100100000000010000000
0100000100000001001000000100000001000000010000100000100000010000010000010100100100010001000100000100000100100000000010000000