0000000000000000000000000000000000000000000000000000000000000900000000000000000000000000000000000000000000000000000000000000
000000000000000000000000000000000000000000*000000*00000000000000000000000000000000000000000000000000000000000000000000000000
000000000000000000000000000*000000*00000000222222000000022222222000000000000000000000000000000000000000000000000000000000000
0000000000000000000000000000222222000000000111111000000000000000000000000000000000000000000000000000000000000000000000000000
0000000000000000000000022000111111222222222111111000000000000000000000000000000000000000000000000000000000000000000000000000
000000000000000*0000*0000000111111111111111111111000000000000000000000000000000000000000000000000000000000000000000000000000
0000000000000000222200000000000000000000000000000000000000000000000000000000000000000000000000000000000000000000000000000000
0*000000000*0000000000000000000000000000000000000000000000000000000000000000000000000000000000000000000000000000000000000000
0022222222200000000000000000000000000000000000000000000000000000000000000000000000000000000000000000000000000000000000000000
0000000000000000000000000000000000000000000000000000000000000000000000000000000000000000000000000000000000000000000000000000
0000000000000000000000000000000000000000000000000000000000000000000000000000000000000000000000000000000000000000000000000000
2222222222222222222200000000000000000000000000000000000000000000000000000000000000000000000000000000000000000000000000000000
11111111111111111111000*000000*000000000000000000000000000000000000000000000000000000000000000000000000000000000000000000000
1111111111111111111100002222220000022200000000000000000000000000000050000000000000000000000000000000000000000000000000000000
0000000000000000000000001111110000011100000000000000000000000000000022000000000000000000000000000000000000000000000000000000
000000000000000000000000000000000001110000022000000000000000022000000000*00000000*000000000000000000000000000000000000000000
00000000000000000000000000000000000111000001d0000000**0000000d10000000000222222220000000000000000000000000000000000000000000
0000000000000000000000000000000000000000000112222222222222222110000000000111111110000000000000000000000000000000000000000000
0000000000000000000000000000000000000000000111111111111111111110000000000000000000000000000000000000000000000000000000000000
0000000000000000000000000000000000000000000000000000000000000000000000000000000000000022200000000000000000000000000000000000
0000000000000000000000000000000000000000000000000000000000000000000000000000000000000000000000000000000000000000000000000000
0000000000000000000000000000000000000000000000000000000000000000000000000000000000000000000000000000000000000000000000000000
0000000000000000000000000000000000000000000000000000000000000000000000000000000000000000000000222000000000000000000000000000
0000000000000000000000000000000000000000000000000000000000000000000000000000000000000000000000000000000000000000000000000000
0000000000000000000000000000000000000000000000000000000000000000000000000000000000000000000000000000000000000000000000000000
0000000000000000000000000000000000000000000000000000000000000000000000000000000000000000000000000000222200000000000000000000
00000000000000000000000000000000000000000000000000000000000000000000000000000000000040000000000000000000000*0000000*00000000
0000000000000000000000000000000000000000000000000000000000000000000000000000000000222000000000000000000000002222222000000000
0000000000000000000000000000000000000000000000000000000000000000000000000002220000111000000000000000000000001111111000000000
000000000000000000000000000000000000000000000000000000000000000000g00000000d110000000000000000000000220000001111111000000000
000000000000000000000*000000g2220000000000000000000000000000000000122222222111000000000*0000000*0000110002221111111000000000
0000000000000000000000222222111100000000000000000003000022222000001111111111110000000000222222200000000000000000000000000000
0000000000000022222222111111111100002g0000000*000022000011111000001111111111110000000000111111100000000000000000000000000000
0000008000000011111111111111111100001122222220000000000000000000000000000000000000000000111111100000000000000000000000000000
2222222220000011111111111111111100001111111110000000000000000000000000000000000000000000000000000000000000000000000000000000
1111111110000000000000000000000000001111111110000000000000000000000000000000000000000000000000000000000000000000000000000000
1111111110000000000000000000000000000000000000000000000000000000000000000000000000000000000000000000000000000000000000000000