0000000000000000000000000000000000000000000000000000000000000000000000000000000000000000000000000000000000000000000000000000
0000000000000000000000000000000000000000000000000000000000000000000000000000000000000000000000000000000000000000000000000000
0000000000000000000000000000000000000000000000000000000000000000000000000000000000000000000000000000000000000000000000000000
0888000000000000000000000000000000000000000000000000000000000000000000000000000000000000000000000000000000000000000000000000
2222000000000000000000000000000000000000000000000000000000000000000000000000000000000000000000000000000000000000000000000000
1111200000000000000000000000000000000000000000000000000000000000000000000000000000000000000000000000000000000000000000000000
11000000000000000000*008800*000000000000000000000000000000000000000000000000000000000000000000000000000000000000000000000000
1190000500000000000002222220000000000000000000000000000000000000000000000000000000000000000000000000000000000000000000000000
1100002222200000000000000000000000000000000000000000000000000000000000000000000000000000000000000000000000000000000000000000
112222111110002g0088000**0008800g2000000000000000000000000000000000000000000000000000000000000000000000000000000000000000000
1111111111100011222222222222222211000000000000008000000000000000000000000000000000000000000000000000000000000000000000000000
1111111111100011111111111111111111002200000000000000000000000000000000000000000000000000000000000000000000000000000000000000
1111111111100001111111111111111110001100002222000000000000000000000000000000000000000000000000000000000000000000000000000000
1111111111100000000000000000000000001100001111000000040000g0008800gg0000000*000000000000000000000000000000000000000000000000
1111111111100000000000000000000000001100001111000002222222122222221122222220000000000000000000000000000000000000000000000000
0000000000000000000000000000000000001100001111000001111111111111111111111110000000000000000000000000000000000000000000000000
0000000000000000000000000000000000001100001111000001111111111111111111111110000000000000000000000000000000000000000000000000
0000000000000000000000000000000000000000000000000001111111111111111111111110000000000000000000000000000000000000000000000000
0000000000000000000000000000000000000000000000000001111111111111111111111112200000000000000000000000000000000000000000000000
0000000000000000000000000000000000000000000000000001111111111111111111111111100000000000000000000000000000000000000000000000
0000000000000000000000000000000000000000000000000001111111111111111111111110000000000000000000000000000000000000000000000000
00000000000000000000000000000000*0000880000g22200001111111111111111111111110000002222200000000000000000000000000000000000000
0000000800080000000000000000000002222222222111100001111111111111111111111110000001111100000000000000000000000000000000000000
0000000000000000000000000220000001111111111111108001111111111111111111111110000000000000000000000000000000000000000000000000
0000000000000000000002222110000000111111111111100001111111111111111111111112200000000000000000000000000000000000000000000000
0000000000000000000001111110000000001111111111100001111111111111111111111111100000000000000000000000000000000000000000000000
2222222222222222000000111110000000000011111111100801111111111111111111111111000082228000000000000000002220000000000000000000
1111111111111111000000011110000000000001111111100001111111111111111111111110000021112000000000000000221110000000000000000000
1111111111111111000000000010000000000000011111100001111111111111111111111110000011111000000000000002111110000002220000000000
1111111111111111000000000000000000000000001111100000000000000000000000000000000000000000000000000001111110000001110000088880
1111111111111111000000000000000000000000001111108000000000000000000000000000000000000000002222200000000000000000000000222222
1111111111111111000000000000000000000000000111100000000000000000000000000000000000000000001111100000000000000000000000111111
1111111111111111000000000000000000000000000011100000000000000000000000000000000000000000001111100000000000000000000000000000
1111111111111111000000000000000000000000000011100000000000000000000000000000000022222000001111100000000000000000000000000000
111111111111111100000000000000000000000000001110000002g000800g20000003000000000011111000000000000000000000000000000000000000
1111111111111111000000000000000000000000000011122222211222222112222222222220000011111000000000000000000000000000000000000000
1111111111111111000000000000000000000000000011111111111111111111111111111110000000000000000000000000000000000000000000000000
0000000000000000000000000000000000000000000011111111111111111111111111111110000000000000000000000000000000000000000000000000
0000000000000000000000000000000000000000000011111111111111111111111111111110000000000000000000000000000000000000000000000000
0000000000000000000000000000000000000000000011111111111111111111111111111110000000000000000000000000000000000000000000000000
0000000000000000000000000000000000000000000011111111111111111111111111111110000000000000000000000000000000000000000000000000
0000000000000000000000000000000000000000000011111111111111111111111111111110000000000000000000000000000000000000000000000000
0000000000000000000000000000000000000000000011111111111111111111111111111110000000000000000000000000000000000000000000000000
0000000000000000000000000000000000000000000011111111111111111111111111111110000000000000000000000000000000000000000000000000
0000000000000000000000000000000000000000000011111111111111111111111111111110000000000000000000000000000000000000000000000000
0000000000000000000000000000000000000000000011111111111111111111111111111110000000000000000000000000000000000000000000000000
0000000000000000000000000000000000000000000011111111111111111111111111111110000000000000000000000000000000000000000000000000
0000000000000000000000000000000000000000000011111111111111111111111111111110000000000000000000000000000000000000000000000000
0000000000000000000000000000000000000000000011111111111111111111111111111110000000000000000000000000000000000000000000000000