0000000000000000000000000000000000000000000000000000000000000000000000000000000000000000000000000000000000000000000000000000
0000000000000000000000000000000000000000000000000000000000000000000000000000000000000000000000000000000000000000000000000000
0000000000000000000000000000000000000000000000000000000000000000000000000000000000000000000000000000000000000000000000000000
0000000000000000000000000000000000000000000000000000000000000000000000000000000000000000000000000000000000000000000000000000
0000000000000000000000000000000000000000000000000000000000000000000000000000000000000000000000000000000000000000000000000000
0000000000000000000000000000000000000000000000000000000000000000000000000000000000000000000000000000000000000000000000000000
00000000000000000000*000000*000000000000000000000000000000000000000000000000000000000000000000000000000000000000000000000000
0090000500000000000002222220000000000000000000000000000000000000000000000000000000000000000000000000000000000000000000000000
0000002222200000000000000000000000000000000000000000000000000000000000000000000000000000000000000000000000000000000000000000
222222111110002g0000000**0000000g2000000000000000000000000000000000000000000000000000000000000000000000000000000000000000000
1111111111100011222222222222222211000000000000000000000000000000000000000000000000000000000000000000000000000000000000000000
0000000000000000000000000000000000002200000000000000000000000000000000000000000000000000000000000000000000000000000000000000
0000000000000000000000000000000000001100222222000000000000000000000000000000000000000000000000000000000000000000000000000000
0000000000000000000000000000000000001000111111000000040000g0000000gg0000000*000000000000000000000000000000000000000000000000
0000000000000000000000000000000000000000111000000002222222122222221122222220000000000000000000000000000000000000000000000000
0000000000000000000000000000000000000000010000000001111111111111111111111110000000000000000000000000000000000000000000000000
0000000000000000000000000000000000000000000000000001111111111111111111111110000000000000000000000000000000000000000000000000
0000000000000000000000000000000000000000000000000001111111111111111111111110000000000000000000000000000000000000000000000000
0000000000000000000000000000000000000000000000000001111111111111111111111112200000000000000000000000000000000000000000000000
0000000000000000000000000000000000000000000000000001111111111111111111111111100000000000000000000000000000000000000000000000
0000000000000000000000000000000000000000000000000001111111111111111111111110000000000000000000000000000000000000000000000000
00000000000000000000000000000000*0000000000g22200001111111111111111111111110000002220000000000000000000000000000000000000000
0000000000000000000000000000000002222222222111100001111111111111111111111110000001110000000000000000000000000000000000000000
0000000000000000000000000220000001111111111111100001111111111111111111111110000000000000000000000000000000000000000000000000
0000000000000000000002222110000000111111111011100001111111111111111111111112200000000000000000000000000000000000000000000000
0000000000000000000001111110000000111111110011100001111111111111111111111111100000000000000000000000000000000000000000000000
2222222222222222000000111110000000000011110011100001111111111111111111111111000002220000000000000000000000000000000000000000
1111111111111111000000010110000000000001100011100001111111111111111111111110000001112000000000000000000000000000000000000000
1111111111111111000000000010000000000000000011100001111111111111111111111110000001111000000000000000000000000000000000000000
1111111111111111000000000000000000000000000011100000000000000000000000000000000000000000000000000000000000000000000000000000
1111111111111111000000000000000000000000000011100000000000000000000000000000000000000000002222200000000000000000000000000000
0000000000000000000000000000000000000000000011100000000000000000000000000000000000000000001111100000000000000000000000000000
0000000000000000000000000000000000000000000011100000000000000000000000000000000000000000001111100000000000000000000000000000
0000000000000000000000000000000000000000000011100000000000000000000000000000000022222000001111100000000000000000000000000000
000000000000000000000000000000000000000000001110000002g000000g20000003000000000011111000000000000000000000000000000000000000
0000000000000000000000000000000000000000000011122222211222222112222222222220000011111000000000000000000000000000000000000000
0000000000000000000000000000000000000000000011111111111111111111111111111110000000000000000000000000000000000000000000000000