0000000000000000000000000000000000000000000000000000000000000000000000000000000000000000000000000000000000000000000000000000
0000000000000000000000000000000000000000000000000000000000000000000000000000000000000000000000000000000000000000000000000000
0000000000000000000000000000000000000000000000000000000000000000000000000000000000000000000000000000000000000000000000000000
0000000000000000000000000000000000000000000000000000000000000000000000000000000000000000000000000000000000000000000000000000
0000000000000000000000000000000000000000000000000000000000000000000000000000000000000000000000000000000000000000000000000000
0000000000000000000000000000000000000000000000000000000000000000000000000000000000000000000000000000000000000000000000000000
0000000000000000000000000000000000000000000000000000000000000000000000000000000000000000000000000000000000000000000000000000
0000000000000000000000000000000000000000000000000000000000000000000000000000000000000000000000000000000000000000000000000000
0000000000000000000000000000000000000000000000000000000000000000000000000000000000000000000000000000000000000000000000000000
0000000000000000000000000000000000000000000000000000000000000000000000000000000000000000000000000000000000000000000000000000
0000000000000000000000000000000000000000000000000000000000000000000000000000000000000000000000000000000000000000000000000000
0000000000000000000000000000000000000000000000000000000000000000000000000000000000000000000000000000000000000000000000000000
0000000000000000000000000000000000000000000000000000000000000000000000000000000000000000000000000000000000000000000000000000
0000000000000000000000000000000000000000000000000000000000000000000000000000000000000000000000000000000000000000000000000000
0000000000000000000000000000000000000000000000000000000000000000000000000000000000000000000000000000000000000000000000000000
0000000000000000000000000000000000000000000000000000000000000000000000000000000000000000000000000000000000000000000000000000
0000000000000000000000000000000000000000000000000000000000000000000000000000000000000000000000000000000000000000000000000000
0000000000000000000000000000000000000000000000000000000000000000000000000000000000000000000000000000000000000000000000000000
0000000000000000000000000000000000000000000000000000000000000000000000000000000000222222222222222000000000000000000000000000
0000000000000000000000000000000000000000000000000000000000000000000000000000000000111111111111111000000000000000000000000000
0000000000000000000000000000000000000000000000000000000000000000000000000000000222111111111111111000000000000000000000000000
0000000000000000000000000000000000000000000000000000000000000000000000222200000111111111111111111000000222200000000000000000
00000000000000000000000000000000000000000000000000000000000000000000001111000001110000000000000000000001111200*00000*0000000
0000000000000000000000000000000000000000000000000000000000000000220000111100000111000000000000000000005111110002222200000000
0000000000000000000000000000000000000000000000000000000000000000000000111100002111000000000000000000022111100001111100000000
0000000000000000000000000000000000000000000000000000000000220000000000111100000000000000000000000000000111100000000000000000
222222222200000000000000000000000000000000000000000000000000000000000011110000000000g00000g00000g000000d11100000000000000000
1111111111220000000000000000000000000000000000000002200000000000000000111100002222221222221222221222222111100000000000000000
1111111111112200000000000000000000000000000000300000000000000000000000111100000111111111111111111111111111100000000000000000
11111111111111222222000000000000000000000000022000000000000000000000001111200000000000000000000000000001111000*00000*0000000
1111111111111111111122000000000000000000000000000000000000000000000000111100000000000000000000000000000111100002222200000000
111111111111111111111122000000000000000*0000000*0000000000000000000000111100002222222000000000000000000111100001111100000000
1111111111111111111111112g00000000*00000222222200000000000000000000000111100000111111220000000000000000111100000000000000000
111111111111111111111111112222222200000011111110000000000000000000000011112g000d11111112200000000000000111100000090000000000
111111111111111111111111111111111100000011111110000000000000000000000011111111111111111112g00000000*400111100000000000000000
0000000000000000000000000000000000000000111111100000000000000000000000111111111111111111111222222222222111100002222200000000
0000000000000000000000000000000000000000000000000000000000000000000000111111111111111111111111111111111111100001111100000000