000000000000000000000000000000000000000000000000000000000000000000000000000
000000000000000000000000000000000000000000000000000000000000000000000000000
000000000000000000000000000000000000000000000000000000000000000000000000000
000000000000000000000000000000000000000000000000022222222222222200000000000
000000000000000000000000000000000000000000000000011111111111111100000000000
000000000000000000000000000000000000000000000000011111111111111100000000000
000000000400000000000000000000000000009000000000011111111111111120000000000
000000022222000000000000000000000000000000000000011111111111111110000000000
000000000000000000000000000000000002222200000000011111111111111110000000000
220030000000050002200000022222200000111100002220011111111111111100000000222
112222222222222221100002211111120000011000001110011111111111111100000002111
111111111111111111100001111111110000000000001110011111111111111100000221111
111111111111111111100000111111000000000000001110000000000000000000022111111
111111111111111111100000111100000000000000001110000000000000000000211111111
111111111111111111100000110000000000000000001112222222222222222222111111111
111111111111111111100000000000000000000000001111111111111111111111111111111